first_name	last_name
Thaisa	Maecenas
Marina	Pistol
Nora	Saunders
Aidan	Mckinney
Steven	Maldonado
Aadam	Reynolds
Rhys	Lewis
Dion	Albany
Raphael	Thomas
Fletcher	Burch
Theo	Mann
Sarah	Dumaine
Ross	Archer
Geoffrey	Egeus
Michael	Payne
Samuel	Ayala
Hippolyta	Burgundy
Fred	Turner
Mathew	Mora
Valentine	Camillo
